***************************
**********#####************
********##*****##**********
*******#*********#*********
*****************#*********
***0************#**********
***************#***********
*************##************
***********##**************
*********####**************
*******############********
***************************
***************************