###########################
#*************************#
#*************************#
#*************************#
#*************************#
#*************************#
#**********0**************#
#*************************#
#*************************#
#*************************#
#*************************#
#*************************#
###########################