###########################
***************************
***************************
***************************
***************************
***************************
***********0***************
***************************
***************************
***************************
***************************
***************************
###########################